あさのきゃんぱす	浅野キャンパス	固有名詞	東大のキャンパスの一つ。本郷と弥生の間。情報基盤センターがある。
いかとう	イカ東	固有名詞	いかにも東大生の略
いっしょく	一食	固有名詞	東大生協の第一食堂のこと。
おおおに	大鬼	固有名詞	逆評定における教員の評価の一つ。特に厳しい教員につけられる。<->大仏
おおほとけ	大仏	固有名詞	逆評定における教員の評価の一つ。特に優しい教員につけられる。<->大鬼
おなくら	同クラ	固有名詞	同じクラス。「どうくら」と読んだほうがよいだろう。
どうくら	同クラ	固有名詞	同じクラス。「おなくら」とも
かしわきゃんぱす	柏キャンパス	固有名詞	東大のキャンパスの一つ。農学部と工学部の一部が使用。
きほんへいきんてん	基本平均点	固有名詞	東大の進学選択において主に使われる成績の指標。
ぎゃくひょうてい	逆評定	固有名詞	時代錯誤社が出版している、東大の教員についての情報誌。
きゃっぷせい	キャップ制	固有名詞	東大において、履修可能な単位数の上限を30単位とする制度のこと。
こうねん	降年	名詞サ変	東大において、進振りに参加できないまたは進学する学科が決まらず、年度の途中で学年が下になること。
こまばとしょかん	駒場図書館	固有名詞	東大駒場キャンパスにある図書館。
さんがい	三外	固有名詞	第三外国語の略。既習外国語、第二外国語以外の外国語を履修する場合は第三外国語となる。
じだいさくごしゃ	時代錯誤社	固有名詞	東大のサークルの一つ。逆評定や恒河沙を出版。
しゅだいかもく	主題科目	固有名詞	東大の科目種別の一つ。選択科目で、教員の自由な設定に基づく科目が多い。
しんがくふりわけ	進学振分	固有名詞	いわゆる進振り。現在は進学選択に名称が変わっている。
すうりかがくきそ	数理科学基礎	固有名詞	東大の基礎科目の一つ。「すかき」とも
すかき	数理科学基礎	短縮よみ
すうりかがくきそえんしゅう	数理科学基礎演習	固有名詞	東大の基礎科目の一つ。「すかきえん」とも
すかきえん	数理科学基礎演習	短縮よみ
すうりびょうとう	数理病棟	固有名詞	駒場の数理科学研究棟のこと。
そうごうとしょかん	総合図書館	固有名詞	東大本郷キャンパスにある図書館。
せんもんかもく	専門科目	固有名詞	東大の科目種別の一つ。後期課程の単位として認定される科目。
そうごうかもく	総合科目	固有名詞	東大の科目種別の一つ。選択科目で、語学のL系列、その他のA-F系列に分けられる。