浅野キャンパス	あさのきゃんぱす	固有名詞	東大のキャンパスの一つ。本郷と弥生の間。情報基盤センターがある。
イカ東	いかとう	固有名詞	いかにも東大生の略
一食	いっしょく	固有名詞	東大生協の第一食堂のこと。
大鬼	おおおに	固有名詞	逆評定における教員の評価の一つ。特に厳しい教員につけられる。<->大仏
大仏	おおほとけ	固有名詞	逆評定における教員の評価の一つ。特に優しい教員につけられる。<->大鬼
同クラ おなくら	固有名詞	同じクラス。「どうくら」と読んだほうがよいだろう。
同クラ どうくら	固有名詞 同じクラス。「おなくら」とも
柏キャンパス	かしわきゃんぱす	固有名詞	東大のキャンパスの一つ。農学部と工学部の一部が使用。
基本平均点	きほんへいきんてん	固有名詞	東大の進学選択において主に使われる成績の指標。
逆評定	ぎゃくひょうてい	固有名詞	時代錯誤社が出版している、東大の教員についての情報誌。
キャップ制	きゃっぷせい	固有名詞	東大において、履修可能な単位数の上限を30単位とする制度のこと。
降年	こうねん	名詞サ変	東大において、進振りに参加できないまたは進学する学科が決まらず、年度の途中で学年が下になること。
駒場図書館	こまばとしょかん	固有名詞	東大駒場キャンパスにある図書館。
三外	さんがい	固有名詞	第三外国語の略。既習外国語、第二外国語以外の外国語を履修する場合は第三外国語となる。
時代錯誤社	じだいさくごしゃ	固有名詞	東大のサークルの一つ。逆評定や恒河沙を出版。
主題科目	しゅだいかもく	固有名詞	東大の科目種別の一つ。選択科目で、教員の自由な設定に基づく科目が多い。
進学振分	しんがくふりわけ	固有名詞	いわゆる進振り。現在は進学選択に名称が変わっている。
数理科学基礎	すうりかがくきそ	固有名詞	東大の基礎科目の一つ。「すかき」とも
数理科学基礎	すかき	短縮よみ
数理科学基礎演習	すうりかがくきそえんしゅう	固有名詞	東大の基礎科目の一つ。「すかきえん」とも
数理科学基礎演習	すかきえん 短縮よみ
数理病棟	すうりびょうとう	固有名詞	駒場の数理科学研究棟のこと。
総合図書館	そうごうとしょかん	固有名詞	東大本郷キャンパスにある図書館。
専門科目	せんもんかもく	固有名詞	東大の科目種別の一つ。後期課程の単位として認定される科目。
総合科目	そうごうかもく	固有名詞	東大の科目種別の一つ。選択科目で、語学のL系列、その他のA-F系列に分けられる。